###########################
#...........*.............#
#.........................# 
#.........................#
#.................~~~~....#
#.++++++++................#
#.........................#
#.......................*.#
#..*......................#
#.........................#
#.......+++++++++.........#
#.........................#
#.........................#
#....~~~..................#
#...~~~~~.................#
#.....~~~~~...............#
#*.~~~~~~.................#
#..............*......+++.#
#.........................#
#.........................#
#.........................#
#.........................#
###########################