ski+-------------------------+
|...........*.............|
|.........................| 
|.........................|
|.................~~~~....| 
|.++++++++................|
|.........................|
|.......^^^^^^^^^^......*.|
|..*......................|
|.........................|
|.......+++++++++.........|
|.........................|
|.........................|
|....~~~..................|
|...~~~~~.................|
|.....~~~~~...............|
|*.~~~~~~.................|
|..............*......+++.|
|.........................|
|.........................|
|.........................|
|.........................|
+-------------------------+